22 12
0000000000100000000000
0000000000000000000000
0011000000000000000000
0011000000100000000000
0000000000100000000000
0000000000111111111001
1001111111100000000000
0000000000100000000000
0011000000100000001100
0011000000000000001100
0000000000000000000000
0000000000100000000000
