22 12
0000100000100000100000
0000100000000000100000
0000100000000000100000
0000100000100000100000
0000100000100000100000
0000000000100000000000
0000000000100000000000
0000100000100000100000
0000100000100000100000
0000100000000000100000
0000100000000000100000
0000100000100000100000
